20,  20,  20,  20,  20,  20,  20,  20,  20,  20,  20
20,  20,  30,  30,  20,  20,  20,  30,  30,  20,  20
20,  30,  70,  70,  30,  20,  30,  70,  70,  30,  20
30,  90,  70,  70,  70,  30,  70,  70,  70,  90,  30
30,  90,  70,  70,  60,  60,  60,  70,  70,  90,  30
20,  30,  70,  70,  60,  80,  60,  70,  70,  30,  20
20,  20,  30,  70,  60,  60,  60,  70,  30,  20,  20
20,  20,  20,  30,  90,  90,  90,  30,  20,  20,  20
20,  20,  20,  20,  30,  90,  30,  20,  20,  20,  20
20,  20,  20,  20,  20,  30,  20,  20,  20,  20,  20