20,    20,    20,    20,    20,    20,    20,    20,    20,    20,  20
20,    11,    20,    20,    30,    30,    30,    20,    12,    20,  20
20,    20,    20,    20,    30,    90,    30,    20,    11,    20,  20
20,    30,    30,    30,    30,    60,    30,    20,    20,    20,  20
20,    30,    90,    70,    60,    80,    30,    30,    30,    20,  20
20,    30,    30,    30,    60,    70,    70,    70,    30,    20,  20
20,    20,    10,    30,    70,    30,    30,    30,    30,    20,  20
20,    11,    20,    30,    90,    30,    20,    20,    12,    20,  20
20,    11,    20,    30,    30,    30,    20,    12,    20,    20,  20
20,    20,    20,    20,    20,    20,    20,    20,    20,    20,  20