20,  20,  20,  20,  20,  20,  20,  20,  20,  20,  20
20,  30,  30,  30,  30,  30,  20,  20,  10,  11,  20
20,  30,  80,  70,  70,  30,  10,  20,  11,  12,  20
20,  30,  70,  60,  60,  30,  11,  30,  30,  30,  20
20,  30,  70,  60,  70,  30,  12,  30,  90,  30,  20
20,  30,  30,  30,  70,  30,  30,  30,  90,  30,  20
20,  20,  10,  30,  70,  70,  70,  70,  90,  30,  20
20,  12,  30,  70,  70,  70,  40,  70,  70,  30,  20
20,  10,  30,  70,  70,  70,  30,  30,  30,  30,  20
20,  20,  30,  30,  30,  30,  30,  10,  11,  12,  20