20,  20,  20,  20,  20,  20,  20,  20,  20,  20,  20
20,  20,  10,  30,  30,  30,  30,  30,  30,  20,  20
20,  20,  30,  30,  70,  70,  90,  70,  30,  20,  20
20,  20,  30,  70,  60,  70,  30,  70,  30,  20,  20
20,  20,  30,  70,  90,  60,  70,  70,  30,  20,  20
20,  20,  30,  70,  70,  30,  60,  30,  30,  20,  20
20,  20,  30,  90,  70,  80,  70,  30,  20,  20,  20
20,  20,  30,  30,  30,  30,  30,  30,  20,  20,  20
20,  20,  20,  20,  20,  20,  20,  20,  20,  20,  20
20,  20,  20,  20,  20,  20,  20,  20,  20,  20,  20