20,  20,  20,  20,  20,  20,  20,  20,  20,  20,  20
20,  10,  30,  30,  30,  30,  20,  20,  12,  11,  20
20,  11,  30,  80,  70,  30,  30,  30,  10,  12,  20
20,  12,  30,  70,  60,  70,  70,  30,  20,  20,  20
20,  30,  30,  13,  70,  13,  70,  30,  30,  20,  20
20,  30,  90,  14,  70,  14,  70,  70,  30,  11,  20
20,  30,  90,  60,  70,  70,  22,  70,  30,  11,  20
20,  30,  90,  70,  70,  70,  60,  70,  30,  12,  20
20,  30,  30,  30,  30,  30,  30,  30,  30,  10,  20
20,  20,  20,  20,  20,  20,  20,  20,  20,  20,  20